###################################
#                                 #
#                                 #
#             ####                #
#  #          #                   #
#  #          #  #                #
#  ############  #                #
#  #I$$@$$$I# I  #                #
#  #@@@@@@@ @    #                #
#  #$$$$$$I#######                #
#  #@@@@@@@ $                     #
###################################